5
_ _ _ _ _
_ _ X _ _
_ _ _ X _
_ X X X _
_ _ _ _ _
